50
16
196 194 196 194 196 194 196 194 196 194 196 194 196 194 196 194 196 194 196 194 196 194 194 196 194 196 194 196 194 196 194 196 194 196 194 196 194 196 194 196 194 196 194 196 194 196 194 196 194 196 194 194 196 194 196 194 196 194 196 194 196 194 196 194 196 194 196 194 196 194
196 194 196 194 196 194 196 194 196 194 196 194 196 194 196 194 196 194 196 194 196 194 194 196 194 196 194 196 194 196 194 196 194 196 194 196 194 196 194 196 194 196 194 196 194 196 194 196 194 196 194 194 196 194 196 194 196 194 196 194 196 194 196 194 196 194 196 194 196 194
196 194 196 194 196 194 196 194 196 194 196 194 196 194 196 194 196 194 196 194 196 194 194 196 194 196 194 196 194 196 194 196 194 196 194 196 194 196 194 196 194 196 194 196 194 196 194 196 194 196 194 194 196 194 196 194 196 194 196 194 196 194 196 194 196 194 196 194 196 194
196 194 119 120 196 194 196 194 196 194 196 194 196 194 196 194 196 194 196 194 196 194 194 196 194 196 194 196 194 196 194 196 194 196 194 196 194 196 194 196 194 196 194 196 194 196 194 196 194 196 194 194 196 194 196 194 196 194 196 194 196 194 196 194 196 194 196 194 196 194
196 194 150 151 196 194 196 194 196 194 196 194 196 194 196 194 196 194 196 194 196 194 194 196 194 196 194 196 194 196 194 196 194 196 194 196 194 196 194 196 194 196 194 196 194 196 194 196 194 196 194 194 196 194 196 194 196 194 196 194 196 194 196 194 196 194 196 194 196 194
196 194 181 182 2 194 196 194 196 194 196 194 196 194 196 194 196 194 196 194 196 194 194 196 194 196 194 196 194 196 194 196 194 196 194 196 194 196 194 196 194 196 194 196 194 196 194 196 194 196 194 194 196 194 196 194 196 194 196 194 196 194 196 194 196 194 196 194 196 194
196 194 196 194 196 194 196 194 196 194 196 194 196 194 196 194 196 194 196 194 196 194 194 196 194 196 194 196 194 196 194 196 194 196 194 196 194 196 194 196 194 196 194 196 194 196 194 196 194 196 194 194 196 194 196 194 196 194 196 194 196 194 196 194 196 194 196 194 196 194
196 194 196 194 196 194 196 194 196 194 196 194 196 194 196 194 196 194 196 194 196 194 194 196 194 196 194 196 194 196 194 196 194 196 194 196 194 196 194 196 194 196 194 196 194 196 194 196 194 196 194 194 196 194 196 194 196 194 196 194 196 194 196 194 196 194 196 194 196 194
196 194 196 194 196 194 196 194 196 194 196 194 196 194 196 194 196 194 196 194 196 194 194 196 194 196 194 196 194 196 194 196 194 196 194 196 194 196 194 196 194 196 194 196 194 196 194 196 194 196 194 194 196 194 196 194 196 194 196 194 196 194 196 194 196 194 196 194 196 194
196 194 196 194 196 194 196 194 196 194 196 194 196 194 196 194 196 194 196 194 196 194 194 196 194 196 194 196 194 196 194 196 194 196 194 196 194 196 194 196 194 196 194 196 194 196 194 196 194 196 194 194 196 194 196 194 196 194 196 194 196 194 196 194 196 194 196 194 196 194
196 194 196 194 196 194 196 194 196 194 196 194 196 194 196 194 196 194 196 194 196 194 194 196 194 196 194 196 194 196 194 196 194 196 194 196 194 196 194 196 194 196 194 196 194 196 194 196 194 196 194 194 196 194 196 194 196 194 196 194 196 194 196 194 196 194 196 194 196 194
196 194 196 194 196 194 196 194 196 194 196 194 196 194 196 194 196 194 196 194 196 194 194 196 194 196 194 196 194 196 194 196 194 196 194 196 194 196 194 196 194 196 194 196 194 196 194 196 194 196 194 194 196 194 196 194 196 194 196 194 196 194 196 194 196 194 196 194 196 194
196 167 175 176 177 167 196 194 196 194 128 97 196 128 97 194 128 97 196 128 97 194 128 97 194 196 194 196 194 196 194 196 194 196 194 196 194 196 194 196 194 196 194 196 194 196 194 196 194 196 194 194 196 194 196 194 196 194 196 194 196 194 196 194 196 194 196 194 196 194
196 198 206 207 208 198 196 194 196 194 196 194 196 194 196 194 196 194 196 194 196 194 194 196 194 196 194 196 194 196 194 196 194 196 194 196 194 196 194 196 194 196 194 196 194 196 194 196 194 196 194 194 196 194 196 194 196 194 196 194 196 194 196 194 196 194 196 194 196 194
196 194 237 238 239 194 196 194 196 194 196 194 196 194 196 194 196 194 196 194 196 194 194 196 194 196 194 196 194 196 194 196 194 196 194 196 194 196 194 196 194 196 194 196 194 196 194 196 194 196 194 194 196 194 196 194 196 194 196 194 196 194 196 194 196 194 196 194 196 194
1 1 1 1 1 1 1 1 1 1 1 1 1 1 1 1 1 1 1 1 1 1 1 1 1 1 1 1 1 1 1 1 1 1 1 1 1 1 1 1 1 1 1 1 1 1 1 1 1 1 1 1 1 1 1 1 1 1 1 1 1 1 1 1 1 1 1 1 1 1 1 1 1 1 1 1 1 1 1 1 1 1 1 1 1 1 1 1 1 1 1 1