15
15
6 6 6 6 6 6 6 6 6 6 6 6 6 6 6 6 6 6 6 6
6 6 6 6 6 6 6 6 6 6 6 6 6 6 6 6 6 6 6 6
6 6 6 6 6 6 6 6 6 6 6 6 6 6 6 6 6 6 6 6
6 6 6 6 6 6 6 6 6 6 6 6 6 6 6 6 6 6 6 6
6 6 6 6 6 6 8 9 9 9 9 11 6 6 6 6 6 6 6 6
6 6 6 6 6 6 26 44 45 46 47 29 6 6 6 6 6 6 6 6
6 6 6 6 6 6 26 50 51 52 53 41 6 6 6 6 6 6
6 6 6 6 6 6 20 23 6 6 20 23 6 6 6 6 6 6 6 6
6 6 6 6 6 6 26 29 6 6 26 29 6 6 6 6 6 6 6 6
6 6 6 6 6 6 38 41 6 6 38 41 6 6 6 6 6 6 6 6
6 6 6 6 6 6 24 24 6 6 24 24 6 6 6 6 6 6
6 6 6 6 6 6 30 30 6 6 30 30 6 6 6 6 6 6
6 6 6 6 6 6 36 36 6 6 36 36 6 6 6 6 6 6
90 91 94 95 90 91 94 95 90 91 90 91 94 95 90 91 94 95 90 91
91 91 91 91 91 91 91 91 91 91 91 91 91 91 91 91 91 91 91 91